0, 0, 0, 0
0, 1, 2, 3
0, 1, 2, 3
0, 1, 2, 3
3, 0, 0, 0
1, 1, 2, 3
2, 1, 2, 3
3, 3, 4, 3
